Bhojpur	Bhojpur
Dhankuta	Dhankuta
Ilam	Ilam
Jhapa	Bhadrapur
Khotang	Diktel
Morang	Biratnagar
Okhaldhunga	Siddhicharan
Panchthar	Phidim
Sankhuwasabha	Khandbari
Solukhumbu	Salleri
Sunsari	Inaruwa
Taplejung	Taplejung
Terhathum	Myanglung
Udayapur	Gaighat
Saptari	Rajbiraj
Siraha	Siraha
Dhanusa	Janakpur
Mahottari	Jaleshwar
Sarlahi	Malangwa
Bara	Kalaiya
Parsa	Birganj
Rautahat	Gaur
Sindhuli	Kamalamai
Ramechhap	Manthali
Dolakha	Bhimeshwar
Bhaktapur	Bhaktapur
Dhading	Nilkantha
Kathmandu	Kathmandu
Kavrepalanchok	Dhulikhel
Lalitpur	Lalitpur
Nuwakot	Bidur
Rasuwa	Dhunche
Sindhupalchok	Chautara
Chitwan	Bharatpur
Makwanpur	Hetauda
Baglung	Baglung
Gorkha	Gorkha
Kaski	Pokhara
Lamjung	Besisahar
Manang	Chame
Mustang	Jomsom
Myagdi	Beni
Nawalpur	Kawasoti
Parbat	Kusma
Syangja	Putalibazar
Tanahun	Damauli
Kapilvastu	Taulihawa
Parasi	Ramgram
Rupandehi	Siddharthanagar
Arghakhanchi	Sandhikharka
Gulmi	Tamghas
Palpa	Tansen
Dang	Ghorahi
Pyuthan	Pyuthan
Rolpa	Liwang
Eastern Rukum	Rukumkot
Banke	Nepalganj
Bardiya	Gulariya
Western Rukum	Musikot
Salyan	Salyan
Dolpa	Dunai
Humla	Simikot
Jumla	Chandannath
Kalikot	Manma
Mugu	Gamgadhi
Surkhet	Birendranagar
Dailekh	Narayan
Jajarkot	Khalanga
Kailali	Dhangadhi
Achham	Mangalsen
Doti	Dipayal
Bajhang	Jayaprithvi
Bajura	Martadi
Kanchanpur	Bhimdatta
Dadeldhura	Amargadhi
Baitadi	Dasharathchand
Darchula	Darchula